####################
#S...#.#.........#.#
####.#...#.###.#E#.#
#....#.#....########
#.##...######......#
#...#..#...#..######
#####....#.........#
####################